11111111111111111111111111
10000P00000C00000010000001
10C00000000000000010000001
10000000000000000000000C01
11100000000C00001100000001
10000000000C00001100000001
1000C000000000000000000001
10000000000000000000000001
10000000E00011100000000001
10010000000000000000000001
10000000000C00000000000001
11111111111111111111111111